................
..........#.#...
..........#T#...
..........###...
................
S...............
