.....................
..........#.#........
##........#X#........
..........###........
.....................
S....#...............
.....................
.....................
