................
................
...#............
..#T#...........
...#......S.....
................
