................
................
...#............
..#X#...........
...#......S.....
................
